A - (Raw alpha samples) 
AAI - (AAI Dune image) 
AI - (Adobe Illustrator CS2) 
ART - (PFS: 1st Publisher Clip Art) 
AVS - (AVS X image) 
B - (Raw blue samples) 
BGR - (Raw blue, green, and red samples) 
BGRA - (Raw blue, green, red, and alpha samples) 
BIE - (Joint Bi-level Image experts Group interchange format) 
BMP - (Microsoft Windows bitmap image) 
C - (Raw cyan samples) 
CAL - (Continuous Acquisition and Life-cycle Support Type 1) 
CALS - (Continuous Acquisition and Life-cycle Support Type 1) 
CIN - (Cineon Image File) 
CLIPBOARD - (The system clipboard) 
CMYK - (Raw cyan, magenta, yellow, and black samples) 
CMYKA - (Raw cyan, magenta, yellow, black, and alpha samples) 
CUR - (Microsoft icon) 
DCX - (ZSoft IBM PC multi-page Paintbrush) 
DPX - (SMPTE 268M-2003 (DPX 2.0)) 
EPDF - (Encapsulated Portable Document Format) 
EPI - (Encapsulated PostScript Interchange format) 
EPS - (Encapsulated PostScript) 
EPSF - (Encapsulated PostScript) 
EPSI - (Encapsulated PostScript Interchange format) 
EPT - (Encapsulated PostScript with TIFF preview) 
EPT2 - (Encapsulated PostScript Level II with TIFF preview) 
EPT3 - (Encapsulated PostScript Level III with TIFF preview) 
FAX - (Group 3 FAX) 
FITS - (Flexible Image Transport System) 
FTS - (Flexible Image Transport System) 
G - (Raw green samples) 
G3 - (Group 3 FAX) 
GIF - (CompuServe graphics interchange format) 
GIF87 - (CompuServe graphics interchange format) 
GRAY - (Raw gray samples) 
GROUP4 - (Raw CCITT Group4) 
HDR - (Radiance RGBE image format) 
HRZ - (Slow Scan TeleVision) 
ICB - (Truevision Targa image) 
ICO - (Microsoft icon) 
ICON - (Microsoft icon) 
IPL - (IPL Image Sequence) 
J2C - (JPEG-2000 Code Stream Syntax) 
JBG - (Joint Bi-level Image experts Group interchange format) 
JBIG - (Joint Bi-level Image experts Group interchange format) 
JNG - (JPEG Network Graphics) 
JP2 - (JPEG-2000 File Format Syntax) 
JPC - (JPEG-2000 Code Stream Syntax) 
JPEG - (Joint Photographic Experts Group JFIF format) 
JPG - (Joint Photographic Experts Group JFIF format) 
JPX - (JPEG-2000 File Format Syntax) 
K - (Raw black samples) 
M - (Raw magenta samples) 
M2V - (MPEG Video Stream) 
M4V - (Raw MPEG-4 Video) 
MAP - (Colormap intensities and indices) 
MAT - (MATLAB level 5 image format) 
MIFF - (Magick Image File Format) 
MNG - (Multiple-image Network Graphics) 
MONO - (Raw bi-level bitmap) 
MOV - (MPEG Video Stream) 
MP4 - (MPEG-4 Video Stream) 
MPC - (Magick Persistent Cache image format) 
MPEG - (MPEG Video Stream) 
MPG - (MPEG Video Stream) 
MSL - (Magick Scripting Language) 
MSVG - (ImageMagick's own SVG internal renderer) 
MTV - (MTV Raytracing image format) 
MVG - (Magick Vector Graphics) 
NULL - (Constant image of uniform color) 
O - (Raw opacity samples) 
OTB - (On-the-air bitmap) 
PAL - (16bit/pixel interleaved YUV) 
PALM - (Palm pixmap) 
PAM - (Common 2-dimensional bitmap format) 
PBM - (Portable bitmap format (black and white)) 
PCD - (Photo CD) 
PCDS - (Photo CD) 
PCL - (Printer Control Language) 
PCT - (Apple Macintosh QuickDraw/PICT) 
PCX - (ZSoft IBM PC Paintbrush) 
PDB - (Palm Database ImageViewer Format) 
PDF - (Portable Document Format) 
PDFA - (Portable Document Archive Format) 
PFM - (Portable float format) 
PGM - (Portable graymap format (gray scale)) 
PICON - (Personal Icon) 
PICT - (Apple Macintosh QuickDraw/PICT) 
PJPEG - (Joint Photographic Experts Group JFIF format) 
PNG - (Portable Network Graphics) 
PNG24 - (opaque 24-bit RGB) 
PNG32 - (opaque or transparent 32-bit RGBA) 
PNG8 - (8-bit indexed with optional binary transparency) 
PNM - (Portable anymap) 
PPM - (Portable pixmap format (color)) 
PS - (PostScript) 
PSB - (Adobe Large Document Format) 
PSD - (Adobe Photoshop bitmap) 
PTIF - (Pyramid encoded TIFF) 
R - (Raw red samples) 
RAS - (SUN Rasterfile) 
RGB - (Raw red, green, and blue samples) 
RGBA - (Raw red, green, blue, and alpha samples) 
RGBO - (Raw red, green, blue, and opacity samples) 
SGI - (Irix RGB image) 
SUN - (SUN Rasterfile) 
SVG - (Scalable Vector Graphics) 
SVGZ - (Compressed Scalable Vector Graphics) 
TEXT - (Text) 
TGA - (Truevision Targa image) 
TIFF - (Tagged Image File Format) 
TXT - (Text) 
UYVY - (16bit/pixel interleaved YUV) 
VDA - (Truevision Targa image) 
VICAR - (VICAR rasterfile format) 
VID - (Visual Image Directory) 
VIFF - (Khoros Visualization image) 
VST - (Truevision Targa image) 
WBMP - (Wireless Bitmap (level 0) image) 
WMV - (Windows Media Video) 
X - (X Image) 
XBM - (X Windows system bitmap (black and white)) 
XPM - (X Windows system pixmap (color)) 
XV - (Khoros Visualization image) 
XWD - (X Windows system window dump (color)) 
Y - (Raw yellow samples) 
YCbCr - (Raw Y, Cb, and Cr samples) 
YCbCrA - (Raw Y, Cb, Cr, and alpha samples) 
YUV - (CCIR 601 4:1:1 or 4:2:2) 